72 8 8 8 8 8 8 8 136 8 8 8 8 8 8 8 8 8 8 8 
8 136 8 8 8 8 8 8 136 8 8 136 8 8 8 8 8 8 8 8 
8 8 8 8 8 8 8 8 8 8 8 8 8 8 8 8 8 8 8 8 
8 8 8 8 8 8 8 8 8 8 8 8 8 8 8 8 8 8 8 8 
8 8 8 8 8 8 8 8 8 8 8 8 8 8 8 8 8 8 8 8 
8 8 8 8 8 8 8 8 8 8 8 8 8 8 8 8 8 8 8 8 
8 8 8 8 8 8 8 8 8 8 8 8 8 8 8 72 8 8 8 8 
8 8 8 8 8 136 136 8 72 8 8 8 8 8 8 136 8 8 72 8 
8 8 8 8 8 8 8 136 8 8 8 8 8 8 8 8 72 8 8 8 
8 8 8 8 8 8 8 8 72 8 8 8 136 8 8 8 8 8 8 8 
8 8 8 8 8 8 8 8 8 8 8 8 8 136 8 8 8 8 8 8 
136 8 8 8 8 8 8 8 8 8 136 8 136 8 8 8 8 8 8 8 
8 8 8 8 8 8 8 8 8 8 8 8 8 2 2 2 2 8 8 8 
8 8 8 8 8 8 8 8 8 8 8 8 8 2 136 265 2 8 8 8 
8 72 8 8 8 8 8 8 8 8 8 8 8 2 200 152 2 8 8 8 
