24 24 8 24 24 8 24 24 24 24 24 8 24 24 24 24 24 8 24 24 
24 24 8 24 24 8 24 24 8 24 24 8 24 24 24 24 24 8 24 24 
24 24 24 24 24 8 24 24 8 24 24 8 24 24 8 24 24 8 24 24 
24 24 8 24 24 8 24 24 8 24 24 8 24 24 8 24 24 8 24 24 
24 24 8 24 24 8 24 24 8 24 24 8 24 24 8 24 24 8 24 24 
24 24 8 24 24 8 24 24 8 24 24 8 24 24 8 24 24 8 24 24 
24 24 8 24 24 8 24 24 8 24 24 8 24 24 8 24 24 8 24 24 
24 24 8 24 24 8 24 24 8 24 24 8 24 24 8 24 24 8 24 24 
24 24 8 24 24 8 24 24 8 24 24 8 24 24 8 24 24 8 24 24 
24 24 8 24 24 8 24 24 8 24 24 8 24 24 8 24 24 8 24 24 
24 24 8 24 24 8 24 24 8 24 24 24 24 24 8 24 24 8 24 24 
24 24 8 24 24 8 24 24 8 24 24 24 24 24 8 24 24 8 24 24 
24 24 8 24 24 24 24 24 8 24 24 8 24 24 8 24 24 8 24 24 
24 24 8 24 24 8 24 24 8 24 24 8 24 24 8 24 24 24 24 24 
24 24 8 24 24 8 24 24 8 24 24 8 24 24 8 24 24 24 24 24 
