24 24 24 24 24 24 24 24 24 24 24 24 24 24 24 24 24 24 24 24 
24 24 2 2 2 2 2 2 2 24 24 2 2 2 2 2 2 24 24 24 
24 24 2 24 24 24 24 24 24 24 24 24 24 24 24 24 2 24 24 24 
24 24 2 24 24 24 24 24 24 24 24 24 24 24 24 24 2 24 24 24 
24 24 2 24 2 2 2 2 2 2 2 2 2 2 2 24 2 24 24 24 
24 24 2 24 2 24 24 24 24 24 24 24 24 24 2 24 2 24 24 24 
24 24 2 24 2 24 2 2 2 24 2 2 2 24 2 24 2 24 24 24 
24 24 2 24 2 24 2 24 24 24 24 24 2 24 2 24 2 24 24 24 
24 24 2 24 2 24 2 2 2 2 2 2 2 24 2 24 2 24 24 24 
24 24 2 24 2 24 24 24 24 24 24 24 24 24 2 24 2 24 24 24 
24 24 2 24 2 2 2 2 24 2 2 2 2 2 2 24 2 24 24 24 
24 24 2 24 24 24 24 24 24 24 24 24 24 24 24 24 2 24 24 24 
24 24 2 2 2 2 2 2 2 2 2 2 2 2 2 2 2 24 24 24 
24 24 24 24 24 24 24 24 24 24 24 24 24 24 24 24 24 24 24 24 
24 24 24 24 24 24 24 24 24 24 24 24 24 24 24 24 24 24 24 24 
