56 56 56 56 56 56 56 56 40 2 4 2 24 24 24 24 24 24 24 24 
72 56 72 72 56 56 56 56 56 2 2 2 24 24 24 24 24 24 24 24 
56 56 41 56 56 56 56 56 56 2 2 2 2 2 2 2 24 24 24 24 
56 40 56 56 56 40 56 56 56 56 56 56 56 56 40 2 24 24 24 24 
56 40 40 56 2 2 2 2 2 2 2 2 2 2 2 2 24 24 24 24 
56 56 40 40 2 24 24 24 24 24 24 24 24 24 24 24 24 24 24 24 
56 56 56 56 2 24 24 24 24 24 24 24 24 24 24 24 24 24 24 24 
56 56 56 56 2 2 2 2 2 2 2 2 2 2 2 2 24 24 24 24 
56 40 56 40 56 56 56 56 56 56 56 56 56 56 40 2 24 24 24 24 
56 56 2 2 2 2 2 2 2 2 2 2 2 2 2 2 24 24 24 24 
40 40 2 24 24 24 24 24 24 24 24 24 24 24 24 24 24 24 24 24 
24 24 2 2 2 2 2 2 2 2 2 2 2 2 2 2 2 2 2 24 
24 24 24 24 2 24 24 2 24 24 2 24 2 24 24 2 24 24 2 24 
24 24 24 24 2 24 24 2 24 24 2 24 2 24 24 2 24 24 2 24 
24 24 24 24 24 24 24 24 24 24 24 24 24 24 24 24 24 24 24 24 
